{
    "Options": {
        "Assign Power of Wolf relic a unique ID": false,
        "Enable debug mode": true,
        "Skip Maria cutscene in Alchemy Laboratory": false
    },
    "Stages": {
        "Catacombs": {
            "Rooms": {
                "Catacombs, Pitch Black Spike Maze": {
                    "Tilemap": [
                        {
                            "Layer": "Foreground and Background",
                            "Source": [
                                "                                                ",
                                "         @@@@@@@@@@@@@@@@@@@@@@@@@@@@@##        ",
                                "         vvvvvvvvvvvvvvx@@@@vvvvvvvv@@@#        ",
                                "         ..............<@@x(........vv@@        ",
                                "         ..............<@@>...........vv        ",
                                "         ..............<@@>.............        ",
                                "         ..(x)...(^^^^^x@@>...(^^.......        ",
                                "         ..<@>...<@@@@@@@@>...<@@^^.....        ",
                                "         ..<@>...)vvvvvx@x(...)x@@@^^^^^        ",
                                "         ..<@>.........)x(.....<@@@@@@@@        ",
                                "         ..<@>.................<@@@@@@@@        ",
                                "         ..<@x^...............^x@@@@@@@@        ",
                                "         ^^x@@@^^^^^.........^@@@@@@@@@@        ",
                                "         @@@@@@@@@@@^^^^^^^^^@@@@@@@@@@#        ",
                                "         @@@@@@@@@@@@@@@@@@@@@@@@@@@@@##        ",
                                "                                                "
                            ],
                            "Target": [
                                "                                                ",
                                "         @@@@@@@@@@@@@@@@@@@@@@@@@@@@@##        ",
                                "         @@@@>vvvvv<@@@@@@>vvvvvvvvvv<@#        ",
                                "         v<@@>......<@@@@>............<@        ",
                                "         ..<@>......<@@@@>.............v        ",
                                "         ..<@>......<@@@@>..............        ",
                                "         ..<@>...(^<@@@@@>...(^.........        ",
                                "         ..<@>...<@@@@@@@>...<@>^^).....        ",
                                "         ..)v(...)vvvvvvv(...<@@@@>.....        ",
                                "         ....................<@@@@>.....        ",
                                "         ....................<@@@@@>^^^^        ",
                                "         ....................<@@@@@@@@@@        ",
                                "         ^...................<@@@@@@@@@#        ",
                                "         @>^^^^^^^^^^^^^^^^^<@@@@@@@@@##        ",
                                "         @@@@@@@@@@@@@@@@@@@@@@@@@@@@###        ",
                                "                                                "
                            ]
                        }
                    ]
                }
            }
        }
    },
    "Constants": {
        "Message - Richter Mode Instructions 1": "Apologies to DerDrach       ",
        "Message - Richter Mode Instructions 2": "Alpha Build 74.09.03"
    }
}